{
  "tileMap": [
    [406, 406, 406, 406, 406, 406, 406, 406, 406, 406, 406, 406, 406, 406, 406, 406, 406, 406, 406, 406, 406, 406, 406, 406, 406, 406, 406, 406, 406, 406, 406, 406, 406, 406, 406, 406, 406, 406, 406, 406, 406, 406, 406, 406, 406, 406, 406, 406, 406, 406, 406, 406, 406, 406, 406, 406, 406, 406, 406, 406, 406, 406, 406, 406],
    [406, 407, 414, 414, 414, 414, 414, 414, 414, 414, 414, 414, 414, 414, 414, 414, 414, 414, 414, 414, 414, 414, 414, 414, 414, 414, 414, 414, 414, 414, 414, 414, 414, 414, 414, 414, 414, 414, 414, 414, 414, 414, 414, 414, 414, 414, 414, 414, 414, 414, 414, 414, 414, 414, 414, 414, 582, 41, 41, 41, 414, 414, 405, 406],
    [406, 407, -1, -1, -1, -1, -1, -1, -1, -1, -1, -1, -1, -1, -1, -1, -1, -1, -1, -1, -1, -1, -1, -1, -1, -1, -1, -1, -1, -1, -1, -1, -1, 40, 41, 42, -1, -1, -1, -1, -1, -1, -1, -1, -1, -1, -1, -1, -1, -1, -1, -1, -1, -1, -1, 582, 582, 40, 41, 42, 582, -1, 405, 406],
    [406, 407, -1, -1, -1, -1, -1, -1, -1, -1, -1, -1, -1, -1, -1, -1, -1, -1, -1, -1, -1, -1, -1, -1, -1, -1, -1, -1, -1, -1, -1, -1, -1, 40, 41, 42, -1, -1, -1, -1, -1, -1, -1, -1, -1, -1, -1, -1, -1, -1, -1, -1, -1, -1, -1, 582, 582, 40, 41, 42, -1, -1, 405, 406],
    [406, 407, -1, -1, -1, -1, -1, -1, -1, -1, -1, -1, -1, -1, -1, -1, 715, -1, -1, -1, -1, -1, -1, -1, -1, -1, -1, -1, -1, -1, -1, -1, -1, 40, 41, 42, -1, -1, -1, -1, -1, -1, -1, -1, -1, -1, -1, -1, -1, -1, -1, -1, -1, -1, -1, 582, 582, 40, 41, 42, -1, -1, 405, 406],
    [406, 407, -1, -1, -1, -1, -1, -1, -1, -1, -1, -1, -1, 149, 715, 715, 715, 715, -1, -1, -1, -1, -1, -1, -1, -1, -1, -1, -1, -1, -1, -1, -1, 40, 41, 42, -1, -1, -1, -1, -1, -1, -1, -1, -1, -1, -1, -1, -1, -1, -1, -1, -1, -1, -1, 582, 582, 40, 41, 42, -1, -1, 405, 406],
    [406, 407, -1, -1, -1, 715, 715, 715, 715, 715, 715, 715, 715, 715, 715, 715, 715, 715, -1, -1, -1, -1, -1, -1, -1, -1, -1, -1, -1, -1, -1, -1, -1, 40, 41, 42, -1, -1, -1, -1, -1, -1, -1, -1, -1, -1, -1, -1, -1, -1, -1, -1, -1, -1, -1, 582, 582, 40, 41, 42, -1, -1, 405, 406],
    [406, 407, -1, -1, -1, 715, 715, 715, 715, 715, 715, 715, 715, 715, 715, 715, 715, 715, -1, -1, -1, -1, -1, -1, -1, -1, -1, -1, -1, -1, -1, -1, -1, 40, 41, 42, -1, -1, -1, -1, -1, -1, -1, -1, -1, -1, -1, -1, -1, -1, -1, -1, -1, -1, -1, 582, 582, 40, 41, 42, -1, -1, 405, 406],
    [406, 407, -1, -1, -1, 715, 715, 715, 715, 715, 715, 715, 715, 715, 715, 715, 715, 715, -1, -1, -1, -1, -1, -1, -1, -1, -1, -1, -1, -1, -1, -1, -1, 40, 41, 42, -1, -1, -1, -1, -1, -1, -1, -1, -1, -1, -1, -1, -1, -1, -1, -1, -1, -1, -1, 582, 582, 40, 41, 42, -1, -1, 405, 406],
    [406, 407, -1, -1, 715, 715, 715, 715, 715, 715, 715, 715, 715, 715, 715, 715, 715, 715, -1, -1, -1, -1, -1, -1, -1, -1, -1, -1, -1, -1, -1, -1, -1, 40, 41, 42, 248, -1, -1, -1, -1, -1, -1, -1, -1, -1, -1, -1, -1, -1, -1, -1, -1, -1, -1, 582, 582, 40, 41, 42, -1, -1, 405, 406],
    [406, 407, -1, -1, 715, 715, 715, 715, 715, 715, 715, 715, 715, 715, 715, 715, 715, 715, 715, -1, -1, -1, -1, -1, 32, 33, 33, 33, 33, 33, 33, 33, 33, 41, 41, 36, 33, 33, 33, 33, 33, 33, 33, 33, 33, 33, 33, 33, 33, 33, 33, 33, 33, 33, 33, 33, 33, 41, 41, 42, 582, -1, 405, 406],
    [406, 407, -1, -1, 715, 715, 715, 715, 715, 715, 715, 715, 715, 715, 715, 715, 715, 715, 715, 715, 715, -1, -1, -1, 40, 41, 41, 41, 41, 41, 41, 41, 41, 41, 41, 41, 41, 41, 41, 41, 41, 41, 41, 41, 41, 41, 41, 41, 41, 41, 41, 41, 41, 41, 41, 41, 41, 41, 41, 42, 582, -1, 405, 406],
    [406, 407, -1, -1, 715, 715, 715, 715, 715, 715, 715, 715, 715, 715, 715, 715, 715, 715, 715, 715, 715, -1, -1, -1, 40, 41, 44, 49, 49, 49, 49, 49, 49, 43, 41, 41, 49, 49, 49, 49, 49, 49, 49, 49, 49, 49, 49, 49, 49, 49, 49, 49, 49, 49, 49, 49, 49, 49, 49, 50, 582, -1, 405, 406],
    [406, 407, -1, -1, 715, 715, 715, 715, 715, 715, 715, 715, 715, 715, 715, 715, 715, 715, 715, 715, 715, -1, -1, 582, 40, 41, 42, -1, -1, -1, -1, -1, -1, 40, 41, 42, -1, -1, -1, -1, -1, 564, -1, 564, 564, 564, 564, 564, -1, 564, 564, 564, -1, -1, -1, -1, -1, -1, -1, -1, 582, -1, 405, 406],
    [406, 407, -1, -1, -1, -1, -1, -1, -1, -1, 715, 715, 715, 715, 715, 715, 715, 715, 715, 715, 715, 32, 33, 33, 35, 41, 42, -1, -1, -1, -1, -1, -1, 40, 41, 42, -1, -1, -1, 564, 564, 564, 564, 564, -1, -1, -1, -1, -1, 564, 564, 564, -1, -1, -1, -1, -1, -1, -1, -1, -1, -1, 405, 406],
    [406, 407, -1, -1, -1, -1, -1, -1, -1, -1, -1, -1, 715, 715, 715, 715, 715, 715, 715, 715, 715, 40, 41, 41, 41, 41, 42, -1, -1, -1, -1, -1, -1, 40, 41, 42, -1, -1, -1, -1, -1, -1, -1, -1, -1, -1, -1, -1, -1, 564, 564, 564, -1, -1, -1, -1, -1, -1, -1, -1, -1, -1, 405, 406],
    [406, 407, -1, -1, 582, 582, 582, 582, 582, -1, -1, -1, 715, 715, 715, 715, 715, 715, 715, 715, 715, 48, 49, 49, 49, 49, 50, -1, -1, -1, -1, -1, -1, 40, 41, 42, -1, -1, -1, -1, -1, -1, -1, -1, -1, -1, -1, -1, -1, 564, 564, 564, 564, -1, -1, -1, -1, -1, -1, -1, -1, -1, 405, 406],
    [406, 407, -1, -1, -1, -1, 32, 33, 34, -1, -1, -1, 715, 715, 715, 715, 715, 715, 715, 715, 715, -1, 582, -1, -1, -1, -1, -1, -1, -1, -1, -1, -1, 40, 41, 42, -1, -1, -1, -1, -1, -1, -1, -1, -1, -1, -1, -1, -1, 564, 564, 564, 564, -1, -1, -1, -1, -1, -1, -1, -1, -1, 405, 406],
    [406, 407, -1, -1, -1, -1, 40, 41, 42, -1, -1, 715, 715, 715, 715, 715, 715, 715, 715, 715, 715, -1, -1, -1, -1, -1, -1, -1, -1, -1, -1, -1, -1, 40, 41, 42, -1, -1, -1, -1, -1, -1, -1, -1, -1, -1, -1, -1, -1, 564, 564, 564, 564, 564, -1, -1, -1, -1, -1, -1, -1, -1, 405, 406],
    [406, 407, -1, -1, -1, -1, 40, 41, 42, -1, -1, -1, -1, -1, -1, -1, -1, -1, 715, -1, 715, -1, -1, -1, -1, -1, -1, -1, -1, -1, -1, -1, -1, 40, 41, 42, -1, -1, -1, -1, -1, -1, -1, -1, -1, -1, -1, -1, -1, 564, 564, 564, 564, 564, -1, -1, -1, -1, -1, -1, -1, -1, 405, 406],
    [406, 407, -1, -1, -1, -1, 40, 41, 42, -1, -1, -1, -1, -1, -1, -1, -1, -1, 715, -1, -1, -1, -1, -1, -1, -1, -1, -1, -1, -1, -1, -1, -1, 40, 41, 42, -1, -1, -1, -1, -1, -1, -1, -1, -1, -1, -1, -1, -1, 564, 564, 564, 564, -1, -1, -1, -1, -1, -1, -1, -1, -1, 405, 406],
    [406, 407, -1, -1, -1, -1, 40, 41, 42, -1, -1, -1, -1, -1, -1, -1, -1, -1, -1, -1, 248, 248, 248, 248, 248, 248, -1, -1, -1, -1, -1, -1, -1, 40, 41, 42, 248, 248, 248, -1, -1, -1, -1, -1, -1, -1, -1, -1, -1, 564, 564, 564, 564, -1, -1, -1, -1, -1, -1, -1, -1, -1, 405, 406],
    [406, 407, 33, 33, 33, 33, 35, 41, 36, 33, 33, 33, 33, 33, 33, 33, 33, 33, 33, 33, 33, 33, 33, 33, 33, 33, 33, 33, 33, 33, 33, 33, 33, 41, 41, 41, 33, 33, 33, 33, 33, 33, 33, 33, 33, 33, 33, 33, 33, 33, 34, -1, 564, -1, -1, -1, -1, -1, -1, -1, -1, -1, 405, 406],
    [406, 407, 41, 41, 41, 41, 41, 41, 41, 41, 41, 41, 41, 41, 41, 41, 41, 41, 41, 41, 41, 41, 41, 41, 41, 41, 41, 41, 41, 41, 41, 41, 41, 41, 41, 41, 41, 41, 41, 41, 41, 41, 41, 41, 41, 41, 41, 41, 41, 41, 42, 564, 564, -1, -1, -1, -1, -1, -1, -1, -1, -1, 405, 406],
    [406, 407, 49, 49, 49, 49, 49, 49, 49, 49, 49, 49, 49, 49, 49, 49, 49, 43, 41, 44, 49, 49, 49, 49, 49, 49, 49, 49, 49, 49, 49, 49, 49, 49, 49, 49, 49, 49, 49, 49, 49, 49, 49, 49, 49, 49, 49, 49, 43, 41, 42, -1, -1, -1, -1, -1, -1, -1, -1, -1, -1, -1, 405, 406],
    [406, 407, -1, -1, -1, -1, -1, -1, -1, -1, -1, -1, -1, -1, -1, -1, -1, 40, 41, 42, -1, -1, -1, -1, -1, -1, -1, -1, -1, -1, 248, 248, 248, 248, 248, 248, 248, 248, 248, 248, 248, 248, 248, 248, 248, 248, 248, 248, 40, 41, 42, -1, -1, -1, -1, -1, -1, -1, -1, -1, -1, -1, 405, 406],
    [406, 407, -1, -1, -1, -1, -1, -1, -1, -1, -1, -1, -1, -1, -1, -1, -1, 40, 41, 42, -1, -1, -1, -1, -1, -1, -1, -1, -1, -1, -1, -1, -1, -1, -1, -1, 248, 248, 248, 248, 248, 248, 248, 248, -1, -1, -1, -1, 40, 41, 36, 33, 33, 33, 33, 33, 33, 33, 33, 33, 33, 33, 405, 406],
    [406, 407, -1, -1, -1, -1, -1, -1, -1, -1, -1, -1, -1, -1, -1, -1, -1, 40, 41, 42, -1, -1, -1, -1, -1, -1, -1, -1, -1, -1, -1, -1, -1, -1, -1, -1, -1, -1, -1, -1, -1, -1, -1, -1, -1, -1, -1, -1, 40, 41, 41, 41, 41, 41, 41, 41, 41, 41, 41, 41, 41, 41, 405, 406],
    [406, 407, -1, -1, -1, -1, -1, -1, -1, -1, -1, -1, -1, -1, -1, -1, -1, 40, 41, 42, -1, -1, -1, -1, -1, -1, -1, -1, -1, -1, -1, -1, -1, -1, -1, -1, -1, -1, -1, -1, -1, -1, -1, -1, -1, -1, -1, -1, 40, 41, 44, 49, 49, 49, 49, 49, 49, 49, 49, 49, 49, 49, 405, 406],
    [406, 407, -1, -1, -1, -1, -1, -1, -1, -1, -1, -1, -1, -1, -1, -1, -1, 40, 41, 42, -1, -1, -1, -1, -1, -1, -1, -1, -1, -1, -1, -1, -1, -1, -1, -1, -1, -1, -1, -1, -1, -1, -1, -1, -1, -1, -1, -1, 40, 41, 42, 567, 567, 567, 567, 567, 567, 567, 567, 567, -1, -1, 405, 406],
    [406, 407, -1, -1, -1, -1, -1, -1, -1, -1, -1, -1, -1, -1, -1, -1, -1, 40, 41, 42, -1, -1, -1, -1, -1, -1, -1, -1, -1, -1, -1, -1, -1, -1, -1, -1, -1, -1, -1, -1, -1, -1, -1, -1, -1, -1, -1, -1, 40, 41, 42, -1, -1, 567, 567, 567, 567, -1, -1, -1, -1, -1, 405, 406],
    [406, 407, -1, -1, -1, -1, -1, -1, -1, -1, -1, -1, -1, -1, -1, -1, -1, 40, 41, 42, -1, -1, -1, -1, -1, -1, -1, -1, -1, -1, -1, -1, -1, -1, -1, -1, -1, -1, -1, -1, -1, -1, -1, -1, -1, -1, -1, -1, 40, 41, 42, -1, -1, -1, -1, -1, -1, -1, -1, -1, -1, -1, 405, 406]
  ]
}