{
  "tileMap": [
    [208, 209, 209, 209, 209, 209, 209, 209, 209, 209, 209, 209, 209, 209, 208],
    [216, 217, 217, 217, 217, 217, 217, 217, 217, 217, 217, 217, 217, 217, 228],
    [224, 251, 251, 251, 251, 251, 251, 251, 251, 251, 251, 251, -1, 251, 228],
    [232, 234, 234, 234, 234, 234, 234, 234, 234, 234, 234, 234, 234, 235, 236],
    [243, 243, 243, 243, 243, 243, 243, 243, 243, 243, 243, 243, 243, 243, 243]
  ]
}