{
  "tileMap": [
    [144, 145, 145, 145, 145, 145, 145, 145, 145, 145, 145, 146],
    [152, 153, 153, 153, 153, 153, 153, 153, 153, 153, 153, 154],
    [152, 153, 153, 153, 153, 153, 153, 153, 153, 153, 153, 154],
    [152, 153, 153, 153, 153, 153, 153, 153, 153, 153, 153, 154],
    [152, 153, 153, 153, 153, 153, 153, 153, 153, 153, 153, 154],
    [152, 153, 153, 153, 153, 153, 153, 153, 153, 153, 153, 154],
    [152, 153, 153, 153, 153, 153, 153, 153, 153, 153, 153, 148]
  ]
}